TTTTTTTTTTTTTTTTTTTTTTTTTT
T    T        M  T     TT
T  T  T  T  M  T  T  M  TT
T     T  T  T  T  T     TT
T  T  T  T     T  T  T  TT
T  T  T  T  T  T  T  T  TT
T  T     T  T  T  T  T  TT
T  T  T  T  T     T  T  TT
T  T  T  T  T  T  T  T  TT
T  T  T  M  T  T  T  M  TT
T  T  T  T  T  T  T  T  TT
T  T  M  T  T  T  T  T  TT
T  T  T  T  T  T  T  T  TT
T  T  T  T  T  T  T  TTMTT
T  T  T  T  T  T  T  T  TT
T  T  T  T  T  T  T  T  TT
T  T  T  T  T  T  T  T  TT
T  T  T  T  T  T  T  T  TT
T  T  T  T  T  T  T  T  TT
T  T  T  T  T  T  T  T  TT
T  T  T  T  T  T  T  T  TT
T  T  T  T  T  T  T  T  TT
TBB T  T  T  T  T  M  T TT
TPB T T  T  T  T  T  T STT
TTTTTTTTTTTTTTTTTTTTTTTTTT