TTTTTTTTTTTTTTTTTTTT
T                  T
T    M             T
T                  T
T        P         T
T                  T
T             M    T
T                  T
T    M             T
T                  T
TTTTTTTTTTTTTTTTTTTT