TTTTTTTTTTTTTTTTTTTT
T  M  T           TT
T  T  T  T  M  T  TT
T     T  T  T  T  TT
T  T  T  T     T  TT
T  T  T  T  T  T  TT
T  T     T  T  T  TT
T  T  T  T  T     TT
T  T  T  T  T  T  TT
T  T  T  M  T  T PTT
TTTTTTTTTTTTTTTTTTTT