TTTTTTTTTTTT
T   P      T
T   P      D
T   P      T
TTTTTTTTTTTT