TTTTTTTTTT
TP       T
T   D    T
T       PT
TTTTTTTTTT