TTTTTTTTTT
T        T
T   D    T
T       PT
TTTTTTTTTT